NO imgs/a.xml
SO imgs/b.xml
WE imgs/c.xml
EA imgs/d.xml
F 220,100,0
C 225,30,0

1111
110111
1000001
10N001
 10101
100111
111111