NO imgs/red_bricks.xpm
SO imgs/blue_bricks.xpm
WE imgs/castle_wall.xpm
EA imgs/dungeon_wall.xpm
F 220,100,0
C 225,30,0

11111
10001
10001
1000111111111111111111111111111
10000100000000000000000000000011111
1100020000000000000000000000001
100N111111112111111111111111111
1121100000000000000000000000001
1000100000000000000000000000001
1000100000000000000000000000001
1000100000000000000000000000001
1000100000000000000000000000001
1000100000000000000000000000001
1000100000000000000000000000001
1000100000000000000000000000001
1000100000000000000000000000001
1000100000000000000000000000001
1000100000000000000000000000001
1000100000000000000000000000001
1000100000000000000000000000001
1000100000000000000000000000001
12111111111111111111111111111111111
12111
10001
10001
1000111111111111111111111111111
10000100000000000000000000000011111
1100020000000000000000000000001
1000111111112111111111111111111
1121100000000000000000000000001
1000100000000000000000000000001
1000100000000000000000000000001
1000100000000000000000000000001
1000100000000000000000000000001
1000100000000000000000000000001
1000100000000000000000000000001
1000100000000000000000000000001
1000100000000000000000000000001
1000100000000000000000000000001
1000100000000000000000000000001
1000100000000000000000000000001
1000100000000000000000000000001
1000100000000000000000000000001
11111111111111111111111111111111111
