NO imgs/north.xpm
SO imgs/south.xpm
WE imgs/west.xpm
EA imgs/east.xpm
F 173, 216, 230
C 255, 153, 153

11111
10001
10001
1000111111111111111111111111111
10000100000000000000000000000011111
1100000000000000000000000000001
100N111111110111111111111111111
1101100000000000000000000000001
1000100000000000000000000000001
1000100000000000000000000000001
1000100000000000000000000000001
1000100000000000000000000000001
1000100000000000000000000000001
1000100000000000000000000000001
1000100000000000000000000000001
1000100000000000000000000000001
1000100000000000000000000000001
1000100000000000000000000000001
1000100000000000000000000000001
1000100000000000000000000000001
1000100000000000000000000000001
10111111111111111111111111111111111
10111
10001
10001
1000111111111111111111111111111
10000100000000000000000000000011111
1100000000000000000000000000001
1000111111110111111111111111111
1101100000000000000000000000001
1000100000000000000000000000001
1000100000000000000000000000001
1000100000000000000000000000001
1000100000000000000000000000001
1000100000000000000000000000001
1000100000000000000000000000001
1000100000000000000000000000001
1000100000000000000000000000001
1000100000000000000000000000001
1000100000000000000000000000001
1000100000000000000000000000001
1000100000000000000000000000001
1000100000000000000000000000001
11111111111111111111111111111111111
